 18  9  9  9  9  9  9  9  9  9  9  9  9  9  9  9  9  9  9  9  9  9  9 18 18 18 18 18  9  9  9 18
  8  2  2  2  2  2  2  2  2  2  2  2  2  2  2  2  2  2  2  2  2  2  2  7 18 18 18 18  2  2  2  7
  8  0  0  0  0  0  0  0  0  0  0  0  0  0  0  0  0  0  0  0  0  0  0  3 18 18 18  8  0  0  1  7
 18 10 10  6  0  5 10 10 10 10 10  6  0  5 10 10  6  0  5 10 10  6  0  2  7 18 18  8  0 14  0  7
 18 18 18  8  0  7 18 18 18 18 18  8  0  3  9  9  4  0  3 18 18  8  0  0  7 18 18  4  0 12  0  7
 18  9  9  4  0  7 18 18 18 18 18  8  0  2  2  2  2  0  2  7 18 18  6  0  3  9  8  2  0 12  0  7
  8  2  2  2  0  7 18 18 18 18 18  8  0  0  0  0  0  0  0  7 18 18  8  0  2  2 13  0  0 12  0  7
  8  0  0  0  0  3  9  9  9  9  9  4  0  5 10 10 10  6  0  3  9  9 13  0  0  0  2  0  5  8  0  7
 18 10 10  6  0  2  2  2  2  2  2  2  0  7 18 18 18  8  0  2  2  2  2  0 14  0  0  0  3  4  0  7
 18  9  9  4  0  0  0  0  0  0  0  0  0  3 18 18 18  8  0  0  0  0  0  0  7 10  6  0  2  2  0  7
  8  2  2  2  0  5 10  6  0  5 10  6  0  2  3  9  9  4  0 16 10 10 10 10 18 18  8  0  0  0  0  7
  8  1  0  0  0  7 18  8  0  7 18  8  0  0  2  2  2  2  0  2  3  9  9  9  9  9  4  0  5 10 10 18
 18 10 10 10 10 18 18  8  0  7 18 18  6  0  0  0  0  0  0  0  2  2  2  2  2  2  2  0  7 18 18 18
 18 18 18 18 18 18 18  8  0  7 18 18  8  0  5 10 10 10  6  0  0  0  0  0  0  0  0  0  7 18 18 18
 18  9  9  9  9 18 18  8  0  7 18 18  8  0  7 18 18 18 18  6  0  5  6  0  5 10  6  0  7 18 18 18
  8  2  2  2  2  3  9  4  0  3 18 18  8  0  3  9  9  9  9  4  0  7  8  0  7 18  8  0  7 18 18 18
  8  0  0  0  0  2  2  2  0  2  3  9  4  0  2  2  2  2  2  2  0  7  8  0  7 18  4  0  3  9  9 18
 18 10 10  6  0  0  0  0  0  0  2  2  2  0  0  0  0  0  0  0  0  7  8  0  7  8  2  0  2  2  2  7
 18 18 18 18 10 10  6  0 14  0  0  0  0  0  5 10 10 10  6  0  5 18  8  0  7  8  0  0  0  0  0  7
 18 18 18 18 18 18  8  0  7 10 10  6  0  5 18 18 18 18  8  0  3  9  4  0  3  4  0  5 10  6  0  7
 18  9  9  9 18 18  8  0  7 18 18  8  0  7 18  9  9  9  4  0  2  2  2  0  2  2  0  7 18  8  0  7
  8  2  2  2  3  9  4  0  7 18 18  4  0  7  8  2  2  2  2  0  0  0  0  0  0  0  0  7 18  8  0  7
  8  1  0  0  2  2  2  0  7 18  8  2  0  3  4  0  0  0  0  0  5 10 10 10 10  6  0  7 18  8  0  7
 18 10  6  0  0  0  0  0  7 18  8  0  0  2  2  0  5 10  6  0  7 18 18 18 18  4  0  3  9  4  0  7
 18 18 18 10 10 10  6  0  7 18  4  0  0  0  0  0  7 18  8  0  7 18 18 18  8  2  0  2  2  2  0  7
 18 18 18 18 18 18  8  0  7  8  2  0  5 10  6  0  7 18  8  0  7 18 18 18  8  0  0  0  0  0  0  7
 18  9  9  9  9  9  4  0  7  8  0  0  7 18  8  0  7 18  4  0  3  9  9  9  4  0  5 10 10 10 10 18
  8  2  2  2  2  2  2  0  3  4  0  5 18 18  8  0  7  8  2  0  2  2  2  2  2  0  7 18 18 18 18 18
  8  0  0  0  0  0  0  0  2  2  0  7 18 18  8  0  3  4  0  0  0  0  0  0  0  0  3  9  9  9  9 18
  8  0  5  6  0  5  6  0  0  0  0  7 18 18  8  0  2  2  0  5 10 10 10 10  6  0  2  2  2  2  2  7
  8  1  7  8  0  7 18 10 10 10 10 18 18 18  8  0  0  0  0  7 18 18 18 18  8  0  0  0  0  0  1  7
 18 10 18 18 10 18 18 18 18 18 18 18 18 18 18 10 10 10 10 18 18 18 18 18 18 10 10 10 10 10 10 18
