 18  9  9  9  9  9  9  9  9  9  9  9 18 18 18 18 18 18 18 18 18 18  9  9  9  9  9 18 18 18 18 18
  8  0  0  0  0  0  0  0  0  0  0  0  7 18 18 18  9 18 18 18 18  8  0  0  0  0  0  7 18 18 18 18
  8  0  5 10 10 10  6  0  5 11 15  0  3  9  9  4  0  7 18 18 18  8  0  5 10  6  0  3  9  9  9 18
  8  0  7 18 18 18  8  0 12  0  0  0  0  0  0  0  0  3  9  9  9  4  0  3 18  8  0  0  0  0  0  7
  8  0  3  9  9 18  8  0  7 10 10 10 10 10 10  6  0  0  0  0  0  0  0  0  7 18 10 10 10  6  0  7
  8  0  0  0  0  7  8  0  3  9  9 18 18  9  9  8  0  5 10 10 10 10  6  0  3  9  9  9  9  4  0  7
 18 10 10 15  0  7  8  0  0  0  0  7  8  0  0 13  0  3  9  9  9  9  4  0  0  0  0  0  0  0  0  7
 18 18  8  0  0  7 18 10 10  6  0  7  8  0  0  0  0  0  0  0  0  0  0  0  5 10 10 10 10  6  0  7
 18 18  4  0 16  9  9  9  9  4  0  3  9 11 11 15  0  5 10 10 10 10  6  0  7 18 18  9  9  8  0  7
 18  1  0  0  0  0  0  0  0  0  0  0  0  0  0  0  0  7 18 18 18 18  8  0  3  9  4  0  0  7  1 18
 18 18 10  6  0  5  6  0 16 11 11 11 11 11 10  6  0  3  9  9  9 18  8  0  0  0  0  0  0  3  9 18
 18 18 18  8  0  7  8  0  0  0  0  0  0  0  7  8  0  0  0  0  0  7  8  0  5 10 10  6  0  0  0  7
 18 18 18  8  0  7 18 11 11 11 11 11 15  0  3  4  0  5 10  6  0  7  8  0  3 18 18  8  0 17  0  7
 18  9  9  8  0  7  8  0  0  0  0  0  0  0  0  0  0  7 18  8  0  7  8  0  0  7 18  8  0  0  0  7
  8  0  0 13  0  3  4  0  5 10 10 10 10 10 10  6  0  7 18  8  0  7 18  6  0  3  9  4  0 16 11 18
  8  0  0  0  0  0  0  0  7 18 18  9  9  9  9  4  0  7 18  8  0  3  9  4  0  0  0  0  0  0  0  7
 18 11 11 11 11 11 15  0  7 18  8  0  0  0  0  0  0  7 18  8  0  0  0  0  0  5 10 11 11 15  0  7
  8  0  0  0  0  0  0  0  7 18  8  0  5 10 10 10 10 18 18 18 10 10 10  6  0  7  8  0  0  0  0  7
  8  0  5 10 10 11 11 11  9  9  4  0  7 18  9  9  9  9  9  9  9  9  9  4  0  7  8  0  5  6  0  7
  8  0  7 18  8  0  0  0  0  0  0  0  7  8  0  0  0  0  0  0  0  0  0  0  0  7  8  0  7  8  0  7
  8  0  7 18  8  0  5 10 10 10  6  0  7  8  0  5 10  6  0 14  0 16 11 11 11  9  4  0  7  8  0  7
  8  0  3  9  4  0  3  9  9  9  9 10 18  8  0  7 18  8  0 12  0  0  0  0  0  0  0  0  3  4  0  7
 18  1  0  0  0  0  0  0  0  0  0  3  9  4  0  3  9  4  0 12  0  5 10 10 10 10  6  0  0  0  1 18
  8  0  5 10 10  6  0  5 10  6  0  0  0  0  0  0  0  0  0 12  0  3  9  9  9  9  4  0 16 15  0  7
  8  0  7 18 18  8  0  3  9  4  0  5 10 10  6  0  5 10 10  8  0  0  0  0  0  0  0  0  0  0  0  7
  8  0  3  9  9  4  0  0  0  0  0  3  9  9  4  0  3  9  9  4  0  5  6  0  5 10 10  6  0 14  0  7
  8  0  0  0  0  0  0  5 10  6  0  0  0  0  0  0  0  0  0  0  0  7  8  0  3  9  9  4  0 12  0  7
  8  0  5  6  0  5 10 18 18  8  0  5  6  0  5 11 11 11 10  6  0  3  4  0  0  0  0  0  0 12  0  7
  8  0  7  8  0  7 18 18 18  8  0  7  8  0 12  0  0  0  7  8  0  0  0  0  5 10  6  0  5  8  0  7
  8  0  3  4  0  3  9  9  9  4  0  3  4  0 13  0 14  0  3  4  0 16 15  0  3  9  4  0  3  4  0  7
  8  0  0  0  0  0  0  0  0  0  1  0  0  0  0  0 12  0  0  0  0  0  0  1  0  0  0  0  0  0  0  7
 18 10 10 10 10 10 10 10 10 10 18 10 10 10 10 10 18 10 10 10 10 10 10 18 10 10 10 10 10 10 10 18
