 18  9  9  9  9  9 18 18  9  9  9  9  9 18 18 18 18 18 18  9  9  9  9 18 18 18 18 18 18 18  9 18
  8 -1  0  0  0  0  3  4  0  0  0  0  0  7 18  1 18 18  8  0  0  0 -1  7 18 18 18 18 18  8 -1  7
  8  0 16 10  6  0  0  0  0  5 10  6  0  3  4  0  3 18  4  0  5 10 10 18 18 18  9  9  9  4  0  7
  8  0  0  7 18 11 15  0 16  9  9  8  0  0  0  0  0 13  0  0  7  9  9  9 18  8  0  0  0  0  0  7
 18  6  0  7  8  0  0  0  0  0  0  7  6  0  5  6  0  0  0 16  4  0  0  0  3  4  0  5 10  6  0  7
 18  8  0  7  8  0  5 11 11 11 10 18  8  0  3  9 11  6  0  0  0  0 17  0  0  0  0  7  9  4  0  7
 18  4  0  7  8  0 12 -1  0  0  3  9  8  0  0  0  0  7 10 10 15  0  0  0 14  0  5  8  0  0  0  7
  8  0  0  7  4  0  7 11  6  0  0  0  7 10 10  6  0  3  9  4  0  0  5 10  8  0  7 18 10 10 10 18
  8  0  5  8  0  0 12  0 13  0 17  0  7 18 18  4  0  0  0  0  0  5  9  9  4  0  3  9  9  9  9 18
  8  0  3  4  0  5  8  0  0  0  0  0  3  9  4  0  0  5 10 10 10  8  0  0  0  0  0  0  0  0  0  7
  8  0  0  0  0  7  1  0  5 10  6  0  0  0  0  0  5 18 18 18 18  8 -1  5 10 10  6  0  0  5 10 18
 18 10 10 10 10 18 18 10 18 18 18 10 10 10 10 10 18 18 18 18 18 18 10 18 18 18  8  0 16  9  1 18
 18 18 18 18 18 18 18 18 18 18 18 18 18 18 18 18 18 18 18 18 18 18 18 18 18 18  8  0  0  0  0  7
 18 18 18 18 18 18 18 18 18 18 18 18 18 18 18 18 18 18 18 18 18 18 18 18 18 18 18 10 10 10 10 18
 18 18 18 18 18 18 18 18 18 18 18 18 18 18 18 18 18 18 18 18 18 18 18 18 18 18 18 18 18 18 18 18
 18 18 18 18 18 18 18 18 18 18 18 18 18 18 18 18 18 18 18 18 18 18 18 18 18 18 18 18 18 18 18 18
 18 18 18 18 18 18 18 18 18 18 18 18 18 18 18 18 18 18 18 18 18 18 18 18 18 18 18 18 18 18 18 18
 18 18 18 18 18 18 18 18 18 18 18 18 18 18 18 18 18 18 18 18 18 18 18 18 18 18 18 18 18 18 18 18
 18 18 18 18 18 18 18 18 18 18 18 18 18 18 18 18 18 18 18 18 18 18 18 18 18 18 18 18 18 18 18 18
 18 18 18 18 18 18 18 18 18 18 18 18 18 18 18 18 18 18 18 18 18 18 18 18 18 18 18 18 18 18 18 18
 18 18 18 18 18 18 18 18 18 18 18 18 18 18 18 18 18 18 18 18 18 18 18 18 18 18 18 18 18 18 18 18
 18 18 18 18 18 18 18 18 18 18 18 18 18 18 18 18 18 18 18 18 18 18 18 18 18 18 18 18 18 18 18 18
 18 18 18 18 18 18 18 18 18 18 18 18 18 18 18 18 18 18 18 18 18 18 18 18 18 18 18 18 18 18 18 18
 18 18 18 18 18 18 18 18 18 18 18 18 18 18 18 18 18 18 18 18 18 18 18 18 18 18 18 18 18 18 18 18
 18 18 18 18 18 18 18 18 18 18 18 18 18 18 18 18 18 18 18 18 18 18 18 18 18 18 18 18 18 18 18 18
 18 18 18 18 18 18 18 18 18 18 18 18 18 18 18 18 18 18 18 18 18 18 18 18 18 18 18 18 18 18 18 18
 18 18 18 18 18 18 18 18 18 18 18 18 18 18 18 18 18 18 18 18 18 18 18 18 18 18 18 18 18 18 18 18
 18 18 18 18 18 18 18 18 18 18 18 18 18 18 18 18 18 18 18 18 18 18 18 18 18 18 18 18 18 18 18 18
 18 18 18 18 18 18 18 18 18 18 18 18 18 18 18 18 18 18 18 18 18 18 18 18 18 18 18 18 18 18 18 18
 18 18 18 18 18 18 18 18 18 18 18 18 18 18 18 18 18 18 18 18 18 18 18 18 18 18 18 18 18 18 18 18
 18 18 18 18 18 18 18 18 18 18 18 18 18 18 18 18 18 18 18 18 18 18 18 18 18 18 18 18 18 18 18 18
 18 18 18 18 18 18 18 18 18 18 18 18 18 18 18 18 18 18 18 18 18 18 18 18 18 18 18 18 18 18 18 18
