7 8 8 8 8 8 8 8 8 8 8 8 8 8 8 8 8 8 8 8 8 8 8 8 8 8 8 8 8 8 8 6 
7 1 1 1 1 1 1 1 1 1 1 1 1 1 1 1 1 1 1 1 1 1 1 2 1 1 1 7 1 1 1 6 
7 0 0 0 0 0 0 0 0 0 0 0 0 0 0 0 0 0 0 0 0 0 0 1 6 0 0 7 0 0 0 6 
7 9 9 5 0 4 9 9 9 9 9 5 0 4 9 9 5 0 4 9 9 5 0 0 6 0 0 7 0 13 0 6 
7 0 0 7 0 6 0 0 0 0 0 7 0 2 8 8 3 0 2 0 0 0 5 0 6 0 0 3 0 11 0 6 
7 8 8 3 0 6 0 0 0 0 0 7 0 1 1 1 1 0 1 6 0 0 7 0 2 8 7 1 0 11 0 6 
7 1 1 1 0 6 0 0 0 0 0 7 0 0 0 0 0 0 0 6 0 0 7 0 1 1 12 0 0 11 0 6 
7 0 0 0 0 2 8 8 8 8 8 3 0 4 9 9 9 5 0 2 8 8 3 0 0 0 1 0 4 7 0 6 
7 9 9 5 0 1 1 1 1 1 1 1 0 6 0 0 0 7 0 1 1 1 1 0 11 0 0 0 2 3 0 6 
7 8 8 3 0 0 0 0 0 0 0 0 0 2 0 0 0 7 0 0 0 0 0 0 6 9 5 0 1 1 0 6 
7 1 1 1 0 4 9 5 0 4 9 5 0 1 2 8 8 3 0 15 9 9 9 9 0 0 7 0 0 0 0 6 
7 0 0 0 0 6 0 7 0 6 0 7 0 0 1 1 1 1 0 1 2 8 8 8 8 8 3 0 4 9 9 6 
7 0 4 9 9 0 0 7 0 6 0 0 5 0 0 0 0 0 0 0 1 1 1 1 1 1 1 0 6 0 0 6 
7 0 6 0 0 0 0 7 0 6 0 0 7 0 4 9 9 9 5 0 0 0 0 0 0 0 0 0 6 0 0 6 
7 0 2 8 8 0 0 7 0 6 0 0 7 0 6 0 0 0 0 5 0 4 5 0 4 9 5 0 6 0 0 6 
7 0 1 1 1 2 8 3 0 2 0 0 7 0 2 8 8 8 8 3 0 6 7 0 6 0 7 0 6 0 0 6 
7 0 0 0 0 1 1 1 0 1 2 8 3 0 1 1 1 1 1 1 0 6 7 0 6 0 3 0 2 8 8 6 
7 0 4 5 0 0 0 0 0 0 1 1 1 0 0 0 0 0 0 0 0 6 7 0 6 7 1 0 1 1 1 6 
7 0 6 0 9 9 5 0 13 0 0 0 0 0 4 9 9 9 5 0 4 0 7 0 6 7 0 0 0 0 0 6 
7 0 6 0 0 0 7 0 6 9 9 5 0 4 0 0 0 0 7 0 2 8 3 0 2 3 0 4 9 5 0 6 
7 0 2 8 0 0 7 0 6 0 0 7 0 6 0 8 8 8 3 0 1 1 1 0 1 1 0 6 0 7 0 6 
7 0 1 1 2 8 3 0 6 0 0 3 0 6 7 1 1 1 1 0 0 0 0 0 0 0 0 6 0 7 0 6 
7 0 0 0 1 1 1 0 6 0 7 1 0 2 3 0 0 0 0 0 4 9 9 9 9 5 0 6 0 7 0 6 
7 0 13 0 0 0 0 0 6 0 7 0 0 1 1 0 4 9 5 0 6 0 0 0 0 3 0 2 8 3 0 6 
7 0 6 9 9 9 5 0 6 0 3 0 0 0 0 0 6 0 7 0 6 0 0 0 7 1 0 1 1 1 0 6 
7 0 6 0 0 0 7 0 6 7 1 0 4 9 5 0 6 0 7 0 6 0 0 0 7 0 0 0 0 0 0 6 
7 0 2 8 8 8 3 0 6 7 0 0 6 0 7 0 6 0 3 0 2 8 8 8 3 0 4 9 9 9 9 6 
7 0 1 1 1 1 1 0 2 3 0 4 0 0 7 0 6 7 1 0 1 1 1 1 1 0 6 0 0 0 0 6 
7 0 0 0 0 0 0 0 1 1 0 6 0 0 7 0 2 3 0 0 0 0 0 0 0 0 2 8 8 8 8 6 
7 9 9 9 9 5 0 0 0 0 0 6 0 0 7 0 1 1 0 4 9 9 9 9 5 0 1 1 1 1 1 6 
7 0 0 0 0 7 0 4 9 9 9 0 0 0 7 0 0 0 0 6 0 0 0 0 7 0 0 0 0 0 0 6 
7 9 9 9 9 9 9 9 9 9 9 9 9 9 9 9 9 9 9 9 9 9 9 9 9 9 9 9 9 9 9 6 
