 18  9  9  9  9  9 18  9  9  9 18  9  9  9 18  9  9 18  9  9  9 18  9  9  9 18  9  9  9  9  9 18
  8  0  0  0  0  0 12  0  0  0 12  0  0  0 12  0  0 12  0  0  0 12  0  0  0 12  0  0  0  0  0  7
  8  0 16 11 15  0 13  0 14  0 12  0 14  0 12  0  0 12  0 14  0 12  0 14  0 13  0 16 11 15  0  7
  8  0  0  0  0  0  0  0 12  0 13  0 12  0 13  0  0 13  0 12  0 13  0 12  0  0  0  0  0  0  0  7
  8  0 14  0 16 11 11 11  4  0  0  0 12  0  0  0  0  0  0 12  0  0  0  3 11 11 11 16  0 14  0  7
  8  0 12  0  0  0  0  0  0  0  5 11  4  0 14  0  0 14  0  3 11  6  0  0  0  0  0  0  0 12  0  7
  8  0 13  0 16 11 11 11 11 11  8  0  0  0 12  0  0 12  0  0  0  7 10 11 11 11 11 15  0 13  0  7
  8  0  0  0  0  0  0  0  0  1  8  0 16 11  4  0  0  3 11 15  0  7  1  0  0  0  0  0  0  0  0  7
  8  0 16 15  0 16 11 11 11  9  4  0  0  0  0  0  0  0  0  0  0  3  9 11 11 11 15  0 16 15  0  7
  8  0  0  0  0  0  0  0  0  0  0  0  5 11 11 11 11 11 11  6  0  0  0  0  0  0  0  0  0  0  0  7
  8  0 16 15  0 17  0 16 11 11 15  0 13  0  0  0  0  0  0 13  0 16 11 11 15  0 17  0 16 15  0  7
  8  0  0  0  0  0  0  0  0  0  0  0  0  0  5 11 11  6  0  0  0  0  0  0  0  0  0  0  0  0  0  7
  8  0  0  0  0  0  0  0  0  0  0  0  0  0 13  0  0 13  0  0  0  0  0  0  0  0  0  0  0  0  0  7
  8  0  0  0  0  0  0  0  0  0  0  0  0  0  0  0  0  0  0  0  0  0  0  0  0  0  0  0  0  0  0  7
  8  0  0  0  0  0  0  0  0  0  0  0  0  0  0  0  0  0  0  0  0  0  0  0  0  0  0  0  0  0  0  7
  8  0  0  0  0  0  0  0  0  0  0  0  0  0  0  0  0  0  0  0  0  0  0  0  0  0  0  0  0  0  0  7
  8  0  0  0  0  0  0  0  0  0  0  0  0  0  0  0  0  0  0  0  0  0  0  0  0  0  0  0  0  0  0  7
  8  0  0  0  0  0  0  0  0  0  0  0  0  0  0  0  0  0  0  0  0  0  0  0  0  0  0  0  0  0  0  7
  8  0  0  0  0  0  0  0  0  0  0  0  0  0  0  0  0  0  0  0  0  0  0  0  0  0  0  0  0  0  0  7
  8  0  0  0  0  0  0  0  0  0  0  0  0  0  0  0  0  0  0  0  0  0  0  0  0  0  0  0  0  0  0  7
  8  0  0  0  0  0  0  0  0  0  0  0  0  0  0  0  0  0  0  0  0  0  0  0  0  0  0  0  0  0  0  7
  8  0  0  0  0  0  0  0  0  0  0  0  0  0  0  0  0  0  0  0  0  0  0  0  0  0  0  0  0  0  0  7
  8  0  0  0  0  0  0  0  0  0  0  0  0  0  0  0  0  0  0  0  0  0  0  0  0  0  0  0  0  0  0  7
  8  0  0  0  0  0  0  0  0  0  0  0  0  0  0  0  0  0  0  0  0  0  0  0  0  0  0  0  0  0  0  7
  8  0  0  0  0  0  0  0  0  0  0  0  0  0  0  0  0  0  0  0  0  0  0  0  0  0  0  0  0  0  0  7
  8  0  0  0  0  0  0  0  0  0  0  0  0  0  0  0  0  0  0  0  0  0  0  0  0  0  0  0  0  0  0  7
  8  0  0  0  0  0  0  0  0  0  0  0  0  0  0  0  0  0  0  0  0  0  0  0  0  0  0  0  0  0  0  7
  8  0  0  0  0  0  0  0  0  0  0  0  0  0  0  0  0  0  0  0  0  0  0  0  0  0  0  0  0  0  0  7
  8  0  0  0  0  0  0  0  0  0  0  0  0  0  0  0  0  0  0  0  0  0  0  0  0  0  0  0  0  0  0  7
  8  0  0  0  0  0  0  0  0  0  0  0  0  0  0  0  0  0  0  0  0  0  0  0  0  0  0  0  0  0  0  7
  8  0  0  0  0  0  0  0  0  0  0  0  0  0  0  0  0  0  0  0  0  0  0  0  0  0  0  0  0  0  0  7
 18 10 10 10 10 10 10 10 10 10 10 10 10 10 10 10 10 10 10 10 10 10 10 10 10 10 10 10 10 10 10 18
